T9DGFF	Bakos Martin	Tag	

M6X4JS	Borbényi Áron András	Tag	

ENJIPB	Boros Attila Péter	Tag	

C4540B	Geri Botond Máté	Tag	

EXB2DG	Hoang Anh Tuan	Tag	

DPTUX2	Horváth Martin	Tag	

JUCNT1	Koller Tamás	Tag	

UX9WU3	Kovács Adorján Márk	Tag	

BV3B7X	Krebsz Anna Dr.	Adminisztrátor	

YB5TZW	Luksa Norbert	Tag	

FZE5DO	Méhes Nikolett	Tag	

Q3JB1C	Mészáros Lili	Tag	

ETGUH9	Németh Álmos	Tag	

D0W5T4	Podlovics Péter Dávid	Tag	

BZXRI1	Puha Márk	Tag	

DYV6VA	Qian Lívia	Tag	

D0EXP2	Solymosi Zsófia	Tag	

Q4AD0L	Somogyi Ákos	Tag	

EPM7MQ	Székely Gellért	Tag	

HZT7FZ	Tarsoly Gergely	Tag	

HZQ1XC	Tóth Péter	Tag