http://www.cs.ubbcluj.ro/~robu/so2/folyamatok/muvelet.htm#B2
IL4T6B	Albrecht Károly Dániel	Tag	

ZBWZX8	Alföldi Mátyás Mihály	Tag	

WVL2PG	Árkosi Zoltán	Tag	

RHNPD1	Azim János	Tag	

ZVCWE3	Bakó Bence Flórián	Tag	

T9DGFF	Bakos Martin	Tag	

F5L6XU	Balogh István Kristóf	Tag	

DA4WKN	Bárándi Zoltán Félix	Tag	

ZJB63U	Baranek István	Tag	

M1BPU3	Besenyei Bence	Tag	

Y9SBT6	Bokros Ferenc	Tag	

M6X4JS	Borbényi Áron András	Tag	

ENJIPB	Boros Attila Péter	Tag	

HH145R	Buzogány Attila Zsolt	Tag	

RAXBQ2	Császár Zoltán	Tag	

V3ZAUG	Csonka Szilvia	Tag	

D4BN4A	Csonkás Kristóf Gyula	Tag	

GL1K5C	Dan Kristóf Tibor	Tag	

SFDAGZ	Demján Adalbert	Tag	

BS1HB7	Dóczy Dániel Csaba	Tag	

W8CCTI	Donkó István	Tag	

HQMNJE	Duba Sándor Károly	Tag	

RSKS14	Egri Attila	Tag	

sanapci	Elek Dávid	Tag	

HJMVXL	Elmer Balázs	Tag	

LKIS5K	Erdélyi András	Tag	

L3ZI7P	Eszes Bálint	Tag	

DZDG57	Facskó Dávid István	Tag	

Farkas Eszter	Tag	

F1Z22K	Fehér Dániel	Tag	

IHIRL0	Fekete Zsolt Mihály	Tag	

M58CXJ	Ferenci Gergő	Tag	

YV1P83	Ferencz Balázs	Tag	

FSXBOY	Fodor László Tamás	Tag	

OWHVZT	Fóris Klára	Tag	

Q26R88	Gaál Tamás	Tag	

BMN4HZ	Gácsi László	Tag	

K3212B	Géczi Zoltán Csaba	Tag	

DSZEV3	Gelencsér Bence	Tag	

C4540B	Geri Botond Máté	Tag	

S16K8I	Gulyás Gergő	Tag	

VYZJIZ	Gyén Attila	Tag	

EP9KP0	Gyenes Adrienn	Tag	

C4KEG4	Hajdu Róbert	Tag	

DCU6YD	Hart József Dániel	Tag	

B2ICWH	Hausknecht Bálint	Tag	

B4IQ7X	Hegedűs Péter	Tag	

EP5OR4	Heizlerné Bakonyi Viktória Judit	Adminisztrátor	

CHQQ1O	Hetesi Krisztián	Tag	

EWNSQP	Hidi Tamás	Tag	

NUGG03	Hidvégi Patrik Henrik	Tag	

EXB2DG	Hoang Anh Tuan	Tag	

H4WITC	Holler Kristóf	Tag	

HFYCXJ	Hortobágyi Mónika	Tag	

DPTUX2	Horváth Martin	Tag	

KPEDBE	Horváth Mónika Brigitta	Tag	

IJCJYF	Huszár Gyula András	Tag	

SXSGRP	Illés Zoltán Dr.	Adminisztrátor	

NQLHV1	Iványi Blanka	Tag	

SXSP99	Juhász Gábor	Tag	

XA1DSS	Kadlecsik Csaba	Tag	

XXH9FT	Kali András	Tag	

CLGOVZ	Kalmár Mendel Ádám	Tag	

H5BG9F	Kapás Dorina Anita	Tag	

NRSHQU	Kaposvári Tamás Zsolt	Tag	

FM7AUC	Kardos Gergő	Tag	

D7JO4Q	Katona Bence István	Tag	

AI7K1F	Kelemen László	Tag	

ZJI8HW	Keszei Ábel	Tag	

E71JBJ	Kiss Tamás Csaba	Tag	

AT0DUU	Kohári Zsolt	Tag	

EE94UL	Koller Martin Botond	Tag	

JUCNT1	Koller Tamás	Tag	

FZRYUD	Komáromy Barnabás Dávid	Tag	

JM4P3I	Konkolics Kornél Marcell	Tag	

UX9WU3	Kovács Adorján Márk	Tag	

N0XXD4	Kovács Bence	Tag	

UNV1TY	Kovács Dániel	Tag	

IU7YM4	Kovács István Nándor	Tag	

IVHB6N	Kovács Kornélia	Tag	

BWGQW6	Kovács Nándor	Tag	

I42QSG	Kővári Márk	Tag	

G8X4WK	Kulman Dorottya	Tag	

EEXJ3P	Laposa Sándor	Tag	

AGY276	Lévai András	Tag	

MOPKGU	Lévai Krisztián	Tag	

EB9DQY	Lipcsei Ádám	Tag	

WZZLXQ	Lovas Zoltán Róbert	Tag	

Q0JBKK	Lovassy Marcell	Tag	

RH4W3J	Lukács Dávid	Tag	

YB5TZW	Luksa Norbert	Tag	

VW9B2M	Madura Eszter	Tag	

A7DXDW	Makai János	Tag	

RN04IZ	Marton András	Tag	

CDYQ99	Mészáros Előd	Tag	

Q3JB1C	Mészáros Lili	Tag	

PSA24Q	Mikó Péter	Tag	

HP0LHR	Mikola Ferenc	Tag	

WWNJBT	Nagy Rajmund	Tag	

C7OXDE	Negrut Ákos	Tag	

ETGUH9	Németh Álmos	Tag	

MBFRU7	Nyitrai Gergő	Tag	

FNAIAP	Oikonomakis Andreas	Tag	

QZA91Y	Olay Bence	Tag	

BYIAPN	Péderi Gergő	Tag	

D1IICH	Pietraskó Dávid Tibor	Tag	

GEGST8	Pintér Kristóf Balázs	Tag	

D0W5T4	Podlovics Péter Dávid	Tag	

BZXRI1	Puha Márk	Tag	

DYV6VA	Qian Lívia	Tag	

WW9STB	Randjelovic Igor	Tag	

JGNQ59	Réti Marcell	Tag	

JRYD5A	Sámson Adrián	Tag	

CSBCJP	Sándor Attila	Tag	

DZFM8B	Schmidt Márton Tibor	Tag	

DBG8M7	Schuch Dániel	Tag	

J15ZKL	Sebestyén Tamás	Tag	

KL9ZIR	Sebők Tamás	Tag	

JKVREG	Sinkovics Viktória Judit	Tag	

CQ0GI8	Solymosi László	Tag	

D0EXP2	Solymosi Zsófia	Tag	

Q4AD0L	Somogyi Ákos	Tag	

CPSOE2	Soós Ádám	Tag	

ED7Q9D	Sós Krisztián Dávid	Tag	

XKRO7I	Sraj István	Tag	

JQG9LK	Steiner Dániel	Tag	

L657IB	Suszter Anna	Tag	

J1D1YL	Svraka Bence	Tag	

OB2N1N	Szabó Ákos Ferenc	Tag	

L5YEAG	Szabó Áron	Tag	

DURCNP	Szabó Bendegúz Krisztián	Tag	

EPM7MQ	Székely Gellért	Tag	

G6OGXB	Szendrői Imre Árpád	Tag	

UZX7FD	Szilágyi Márton	Tag	

HZT7FZ	Tarsoly Gergely	Tag	

P9O82W	Teleki Miklós	Tag	

GAF6RK	Tóth Katalin Szilvia	Tag	

I8RLHV	Tóth Pál Gábor	Tag	

HZQ1XC	Tóth Péter	Tag	

NLJRAZ	Tóvári Tamás	Tag	

JLX1NJ	Törincsi Attila Gergő	Tag	

PW9YIK	Umann Kristóf	Tag	

TM92YD	Varga Máté István	Tag	

PLEWNA	Városi Bence	Tag	

SP2FJ0	Vecsernyés Márk	Tag	

XYYJ57	Venczák Tamás	Tag	

K2G7J2	Veres Márton	Tag	

FXTIKR	Vida Krisztián	Tag	

XOSDWK	Vida Péter	Tag	

IF2RNM	Vizler Dávid Ferenc	Tag	

IQ7VQ3	Vödrös Viktor	Tag	

FQBOC0	Vörös Krisztián	Tag	

Z0UGJ5	Vukman György